##############################
#............................#
#..####......................#
#..#...#.....................#
#..#...#.....................#
#..#...#.....................#
#..####......................#
#.....&......................#
#............................#
#............................#
#............................#
#............................#
#............................#
#............................#
#............................#
#............................#
#............................#
#............................#
#............................#
#............................#
#............................#
#............................#
#............................#
#............................#
##############################