##########
#........#
#..####..#
#..#...#.#
#..#...#.#
#..#...#.#
#..####..#
#.....&..#
#........#
#........#
#........#
#........#
##########